FILE
+++++*####*+++++*####*++++++#####*+++++*####*+++++*#####+++++**##*+++++++++++++++++++*###*+++++*##%#*+++++*###*++++++*#%##++++++*#%##++++++*####*+++++
+++++++#*#++++++++**#++++++++###++=+++++*#**+++++++*#*#+=+++++*#*--:::-:::::::-:::::--+#*+=+++++###*+++++++###++++++++*##++=+++++*#*++++++++*%*+++++++
+++++**#*+*++++++***+*++++++*#*+*++++++*#*++++++++**#**+++++++**#=----:----------:---=*+*++++++**#**++++++*#*+**+++++*##+**++++***#+**+++++*##*+*+++++
*******#**********#**********#**********##**+*******#**********###---::------------:-#******+****##********##*********###********##**+******#*#*******
**++**####********##********###*#******####********###********####--:::::::::::::::-=###*********###******###********####*******###*#*******####**+++*
+++++++#%####*#################*#*#**##########*#######*#**######+:-::::::::::::::::--###*#*##########*#####*#################################*#+=++++
+++++++**+*#######*=-*#######*=-+#######*=-+*######*+-+########*=-:-:::::::::::::::----+########+==*######*=-=*######*+-=+######*+--*#######++**++++++
*+++++***#+**#****+-:=**#**#*+-:=**#****+--+*+*##**+=:-+****#**=----:::::::::::::::-:---+******+=:-=**#*#*=+=-++*****+=--=******+=:-+******+*****+*+++
********##*==+++==-::--=++++=-:::-=++++=+****+==+++-:-:-=++++=--::--:::::::::::::::----:--====--:-:-=*****+==+======--:::--=====--::--=====-**********
++++++*###-:::-::::-----:-::---:-:---=+#*****+====++=----:----::----::::::::::::::::---::---------=+#*****===+=++=----------::---::---:::::--###++++++
+++++++**+----:::::::::::::-::::::-*#####****+=+=+**+++=-:-::::::::::::::::::::::::::::::::-:::=*#####***#====+****+=:-:::::::::::::::::::---+*+++++++
*+++*+***#=-::::::::::::::::::===+***###*****+=+++******+===-:::::::::::::::::::::::::::::-+=+**********+#+==++*****+++=+::::::::::::::::::-+#*****+++
********##+--::::::::::::::::-++*++*++++++=+*+=++++++++*++++=:::::::::::::::::::::::::::::=++++*+++++++=+#=+=++++++*++*+*=:::::::::::::::::-**#*******
*+++++*###---:::::::::::::::-%++*++*+++++++**+==+++++++*+*++==::::::::::::::::::::::::::::*++*+*++++++++*#+==++++++*++*+*+:::::::::::::::::-=%##*+++++
+==++++*#=---::::::::::------%++*++*+++++****+==+++++++*+*+*+=------:::::::::::::::---::--*++*+*++*+++***#+==++++++*++*+**-------::::::::::--=**++++++
+++++++***---::::::::::------%++*+**++++*****+===++++++*+++++=-------::::::::::::::---:-:-*++*+*+++++****#+===+++++*++*+**-:-----::::::::::-=#+**+++++
***+*****#+-::::::::::-------%++*++*+++##***#*==++*++++*+++*+=-::---::::::::::::::::--::-:*++*+*++++###**#*+=++*+++**+*+**-------::::::::::-**********
***+**####+-::::::::::----::-%+++++++*##**#####*=++**++*+++++=-::---:::::::::::::::---:-:-*++++++++##*#####%#+=**+++++++**::-----::::::::::-+###**++++
+++++++*#+---:::::::::----::-%##**########*+***##**++*###**#++-:-:--::::::::::::::::---:--*#%*#%%%#####*+****##*+*####*##*=------::::::::::--+#*++++++
+++++++***---::::::::::--::--%#%#####%#*+*+=#++*++*#*#++#**#+*+::::-::::::::::::::::---:-:*#%#######****=#++*++*##++***##*+::----:::::::::---#**++++++
**+******#+-::::::::::---::--%#%###%*==============+=+*#**##+*=:----::::::::::::::::---:-:*#%##%#+========--------+****##*+::----:::::::::--+**+***+**
**++**####+-::::::::::----=*+######+===================*##**+*+:::---::::::::::::::----*++*####*===========+++++++++*#*#+*+-:----::::::::::-**##**+++*
+++++++##*---:::::::::----+*=%##*+*+#*+***%#++****#****+*#%*+*+:::--:::::::::::::::--:-#+=*##++*+#*****#*+*+++*++*#++*##**+:::---::::::::::--##*++++++
+++++++**=---:::::::::----+%%#*+*+*+*#######++**+******++##+++=:::--::::::::::::::::-:-#%%##+++++*######*+*+++*****++*#*+++:::---::::::::::--+*+++++++
**++*+***#=--::::::::::-:-+#%#*+****########*************%#+++=:-:--::::::::::::::::---*###*+************************##*+++::----:::::::::--+#****+++*
********##+-:::::::::::-:-++*+++*++++++++++++++++++++++++%#+++=:-:--:::::::::::::::--:=++*+++**++++++++++++++++++++++*#*+++::----:::::::::--**##******
*+++++*###---:::::::::--::-------=++++++++++++++++++++++++++++=:--:-:::::::::::::::--::-------=============================:::---::::::::::--%##*+++++
+++++++*#=---:::::::::--:::--::--::-::::::::::::::::::::::::::-::---::::::::::::::::-::-::------:::::::::::::----:::::::-:--::---::::::::::--=**++++++
*+++++****---:::::::::----::----::::-:::::::--::::::-----:::::--:-:-:::::::::::::::--::----::::---------::--------:::--::--------::::::::::-=#***+++++
********##+-:::::::::::--::----:::::------::::------:::::-----:::::-:::::::::::::::::::::::::::::::::::::::::::::::::::::::::::::::::::::::-**********
**+++**###=--::::::::::::::::::::::::::::::::::::::::::::::::::::::::::::::::::::::::::::::::::::::::::::::::::::::::::::::::::::::::::::::-=###*++=++
=++++++*%+---:::::::::::::::::::::::::::::::::::::::::::::::::::::::::::::::::::::::::::-------------------------------------::::::::::::::---**++=+++
+++++++**+---::::::::::::::::::::::::::::::::::::::::::::::::::::::::::::::::::::::::::+-==================================-=::::::::::::::--+**++++++
***+****##+--::::::::::::--::::---------:::-------::----::-::-::::-:::::::::::::::::-:-+-+************************+*##*+#**-=::--::::::::::-+******+**
**+*****##+--:::::::::------------------------------:--:-----:------:::::::::::::::-::-+-+**++++++++++++++++++++**++***+***-=-:--::::::::::-+##****++*
+++++++##*---:::::::::----:::::--------::---------------+----:-::---:::::::::::::::--:-+-+**=======-=====-====-+*%#%%%%##**-=-:--::::::::::--+##*+++++
+++++++*#=--::::::::::---::::::-:::::::-::-::-:-::-:::+====---::::--:::::::::::::::----+-+**+=-=========--====-=*######****-=-::-::::::::::---*+++++++
*+++++***#=-::::::::::---:::::---=--=-:=-------=------++***-::::::--::::::::::::::::--:+-+**+=-===-=-===========*######****-=-::-::::::::::-=*****+++*
*******###+--:::::::::---:::::-=======================++*++--::-----::::::::::::::::-::+-=++=-------------=--=--========+=+-=-::-::::::::::-+*#****++*
++++++*###---:::::::::---:::::-.:::-------:.::-------::-:::---:::::-:::::::::::::::--::*====================================++=--::::::::::--*##*+++++
+++++++*#+---:::::::::---:::::----:-:-=-----=:::--=-----:-:::-------::::::::::::::::-:-#**######**######################*#***+++-::::::::::---**++++++
++++++***#---:::::::::----::::-------:-:--------:::---:-:::---::::--:::::::::::::::----+***##*+*#*#*+**#*****#**+#*#*++*#****+++-::::::::::-=#*+**++++
********##+--:::::::::----::::---=---:-:-:--==----:-::-:-:::-:::::--:::::::::::::::--:-+*++=*****=*+***+++++=+****=+*****+++*+++--:::::::::-+#********
**++**##*#=--:::::::::-----------------:--------:--:--:-:::::-::::--:::::::::::::::--:-+*++++++++*++++=#*****#+++***++++*+++*+++--:::::::::--###**++++
+++++++*#+---:::::::::---:-----:::::---::::::::::::-:::::::::-::::--:::::::::::::::----+*+++*+++#+++#+=#*+++*%+**++*+++*++++*+++-::::::::::---**++=+++
+++++++**+---:::::::::---------------::::::::---::::-----:::::::::--:::::::::::::::--::+*++++*++*+++*+=######%++**+*++*+++++*++=-::::::::::--+**++++++
**++*****#=--:::::::::----------------------------------------------:::::::::::::::--::-+++*****+*****++++++++++***+******++++++--:::::::::-+*********
**++***###+--::::::::::::::::::::::::::::::::::::::::::::::::::::::::::::::::::::::----:--=++================+==============++==--:::::::::-=##*#*+++*
+=+++++*#*---::::::::::::::::::::::::::::::::::::::::::::::::::::::::::::::::::::::----::-::::::::::::::::::::::::::::::::::::---::::::::::-:-*#++++++
+++++++**+--::::::::::::::::::::::::::::::::::::::::::::::::::::::::::::::::::::::::---:-----:::::------::::------:::::----------::::::::::--=*+++++++
**+++****#=---:::::::::::::::::::::::::::::::::::::::::::::::::::::::::::::::::::::----:-----------------------------------------::::::::::-=#*****+**
***+****##+--====--------==---------==---------------------------::::::::::::::::::::::::::::::::::::::::::::::::::::::::::::::::::::::::::-+#*****++*
+++++++*##++=+++++=-:-+=+++++=---+++++++=-=++=+*++==*++==+*++=++=-:::::::::::::::::::::::::::::::::::::::::::::::::::::::::::::::::::::::::--*##*+=+++
+++++++*#*++++++++**+*+==++++*+++++=+++++*==::.--:.:---:.:--:::==-:::::::::::::::::::::::::::::::::::::::::::::::::::::::::::::::::::::::::---**++++++
*+++++**#****++++**#****++++**#***+++++***#=:++++====+++=+++++.=--:::::::::::::::::::::::::::::::::::::======-:::::::::::::::::::::::::::::--**+*+++++
*******###*********##*+******##****+****+##*-+=++=====++==++=+:=--------------------::--------:--------====-==------------:-----------::----+*********
*+++++*#%##*+++++*####*+++++*####**++++*###+-+====+==========+:=------:::---------::::-----------------+=+++==-=--------:--------::------::--###*+++++
+++++++*#*+++++++++#**+=+++++*#*#++=++++*#*--+=====+===++===++:----:----::::----:::----=======+==+==+==+++++++=+=====+========-::-::-----:::--**++++++
*+++++**#**++++++**#***+++++**#**+++++++**#=:+++=======+=+=+==:=---------::::::---------------------------------------------------------::::-**+*+++++
*******##**********##*+*******#****+******#*===++=====++==+++=:------------::--===-====-=====================-=====-====-======-======------+*********
**+++*####***+++**####***++**####*+*+++*###*:+=====+=++======+.==--:::::---:-==-:::::::::::::::::::::::::::::::==+++==::::==++++=-:--=+++++=+##***++++
==+++++*%#*+=+++++*###+==++++*%##*+=++++*##==+=======++++====+:----:::::::-::--==--==--====-====--====--==---=++=+++++*=-++=+++++*+=*+==+++++**#*+=+++
++++++++#*++++++++*#**+++++++****++++++++*#-:+=====+========++.==--::::::--::::--------::---------:-:-------+**++++++***#*+++++++*#*++++++++**#+++++++
**++****#****++****#****+++***#****+**+***#+=++++====++=++++==:-----:::::::-:::-:-:::-::::::::::--::::::::-+#****++****###********#**********#******+*
*******###********##*********##**********###-=========+=====+=.==----::-:-::--.:::---::--.:::-------::::---###****+***####**+++**####***++**###****++*
+++++++*%#*+=+++++*###++=++++*###*++++++*##==+=======++++====+:------::----:--:---------:-----------:-------*##+++++++*###+=+++++*###*=+++++*###*+=+++
+++++++*#*++++++++***+++++++++#**++++++++**--+===++++========+.==::::-:::::-::-::::--:-::-::-:=-:-::-::-:--:+**+++++++**#*+++++++****+++++++**#*++++++
***+*+**#****+++***#*****++***#****++++***#+-++++=====+==+++==:-===-=+===-==-=--+===-==-======+-==-==-===+=+#****++*****##***+****#*****+****##*****+*
*******###********###********##****+*****###=====+====++====+=:============================================#*#*********###***+***##*#*******###****+**
