MAP.TXT
#####################################################################################################################################################################################################
#000000000000000000000000000000000000000000000000000000000000000000000000000000000000000000000000000000000000000000000000000000000000000000000000000000000000000000000000000000000000000000000000000#
#000000000000000000000000000000000000000000000000000000000000000000000000000000000000000000000000000000000000000000000000000000000000000000000000000000000000000000000000000000000000000000000000000#
#000000000000000000000000000000000000000000000000000000000000000000000000000000000000000000000000000000000000000000000000000000000000000000000000000000000000000000000000000000000000000000000000000#
#000000000000000000000000000000000000000000000000000000000000000000000000000000000000000000000000000000000000000000000000000000000000000000000000000000000000000000000000000000000000000000000000000#
#000000000000000000000000000000000000000000000000000000000000000000000000000000000000000000000000000000000000000000000000000000000000000000000000000000000000000000000000000000000000000000000000000#
#000000000000000000000000000000000000000000000000000000000000000000000000000000000000000000000000000000000000000000000000000000000000000000000000000000000000000000000000000000000000000000000000000#
#000000000000000000000000000000000000000000000000000000000000000000000000000000000000000000000000000000000000000000000000000000000000000000000000000000000000000000000000000000000000000000000000000#
#000000000000000000000000000000000000000000000000000000000000000000000000000000000000000000000000000000000000000000000000000000000000000000000000000000000000000000000000000000000000000000000000000#
#000000000000000000000000000000000000000000000000000000000000000000000000000000000000000000000000000000000000000000000000000000000000000000000000000000000000000000000000000000000000000000000000000#
#000000000000000000000000000000000000000000000000000000000000000000000000000000000000000000000000000000000000000000000000000000000000000000000000000000000000000000000000000000000000000000000000000#
#000000000000000000000000000000000000000000000000000000000000000000000000000000000000000000000000000000000000000000000000000000000000000000000000000000000000000000000000000000000000000000000000000#
#000000000000000000000000000000000000000000000000000000000000000000000000000000000000000000000000000000000000000000000000000000000000000000000000000000000000000000000000000000000000000000000000000#
#000000000000000000000000000000000000000000000000000000000000000000000000000000000000000000000000000000000000000000000000000000000000000000000000000000000000000000000000000000000000000000000000000#
#000000000000000000000000000000000000000000000000000000000000000000000000000000000000000000000000000000000000000000000000000000000000000000000000000000000000000000000000000000000000000000000000000#
#000000000000000000000000000000000000000000000000000000000000000000000000000000000000000000000000000000000000000000000000000000000000000000000000000000000000000000000000000000000000000000000000000#
#00000000000000000000000000000000########################################################################################################################################000000000000000000000000000#
#00000000000000000000000000000000#     \   /      \         /        \  \ \  \  \      __________________________________________/    /   /    /        /      /        #000000000000000000000000000#
#00000000000000000000000000000000# /    \          \ /     / \        \  \ \  \  \____/                     . o.                 \___/   /    /        /      /         #000000000000000000000000000#
#00000000000000000000000000000000#       \/         \     /   \        \  \_\  \_/                  .                          .     \__/    /        /      /    \  \  #000000000000000000000000000#
#00000000000000000000000000000000#        \              /     \        \_/    /                .                            .       .  \___/        /      /          /#000000000000000000000000000#
#00000000000000000000000000000000#\          ___________/   / / \ _____________      ____________________ .                                .\_______/      /          / #000000000000000000000000000#
#00000000000000000000000000000000#   _______/           \       _/\  -  -     /----/|__________________ /\________________     .            o.      \     /   \      /  #000000000000000000000000000#
#00000000000000000000000000000000#  /       \ / -    _   \     /   \  -   -  /----//          -       /\________________  \___            .          \___/      \   /   #000000000000000000000000000#
#00000000000000000000000000000000#_/    -    \    _       \   /  \   _______/----//|_________________/ /               /\___  \_                          \        /    #000000000000000000000000000#
#00000000000000000000000000000000# \      _   \     ________/\     _/      /----//    .   .        .o\_________________ /  /\_  \__                        \      /     #000000000000000000000000000#
#00000000000000000000000000000000#  \/     -     __/          \   /  o.                .                    .o. .      \___ / \__  \___                .o   \    /      #000000000000000000000000000#
#00000000000000000000000000000000#   \          /    \         \_/ .                                                      .\_ /  \___  \      .          . . \__/       #000000000000000000000000000#
#00000000000000000000000000000000#     ________/   \      \    / o.                    ___        .   _  .                  .\__ /  /\  \       .               \       #000000000000000000000000000#
#00000000000000000000000000000000#  __/             \      \__/           .          _/\_/\__|-|_____/ \_____________ o.        \__/  \  \             .         \     /#000000000000000000000000000#
#00000000000000000000000000000000# /     \  -     \        /         .           ___/ _/ \/__|-|      -  -  _____   /\___          \   \  \                       \   / #000000000000000000000000000#
#00000000000000000000000000000000#/  \    \   \    \     _/                o ___/ __|/ .  "  |-|  |-   -|  /_____\   \/ /\ .        \_/ \  \   .                   \_/  #000000000000000000000000000#
#00000000000000000000000000000000#  \ \        \    \___/                   /  __/    ____   |-|    |-    //     \\    /  \__         \_ \  \__           P          \  #000000000000000000000000000#
#00000000000000000000000000000000#  \  \        \___/                     _/ _/  ____/\___/\_|-|  |-  _ - ||     || -  \     \          \ \_/| \____                  \ #000000000000000000000000000#
#00000000000000000000000000000000#\       ______/            .           / / ___/\___\/   \__|-|_____/ \__||     ||___  /   \ \_         \/    /    \____            .o\#000000000000000000000000000#
#00000000000000000000000000000000#  _____/    .                        _/ ' / __\/     .         .     .              \/____  _/       . \\ -   --  / -  \__   .    .o  #000000000000000000000000000#
#00000000000000000000000000000000# /o.                                / . _/ /                                          .   \/      . o  \\   -    /     /  \______ ..o #000000000000000000000000000#
#00000000000000000000000000000000#/ .                                /  o/\_/      .      .                                    . _________\\  _/     -   -  /     /\____#000000000000000000000000000#
#00000000000000000000000000000000#    .    .                      __/ ._/ /                                              . .   _/\          \/    /    /   / -   / /    #000000000000000000000000000#
#00000000000000000000000000000000#                        .      /  . /\_/                                                 o. \  \\____         /   -   _     -   / -   #000000000000000000000000000#
#00000000000000000000000000000000# .  O.                        / __ / /   .                                                   \__  _ _\__       \  _ __    /    /      #000000000000000000000000000#
#00000000000000000000000000000000#   o     .                    |/  | /      . o.             .          .              .      .  \______/\______        \-   -    -    #000000000000000000000000000#
#00000000000000000000000000000000# .                       .   . \__\/                                                              .o.  \/_____/\__________   \ -   \  #000000000000000000000000000#
#00000000000000000000000000000000#                                  \___  ..                                                                    \_________  \_____ - -  #000000000000000000000000000#
#00000000000000000000000000000000#\__   .                        .      \____       .                                        .                       O .  \_/    /\____ #000000000000000000000000000#
#00000000000000000000000000000000#   \____     .                        .o.  \        .                      .                                   .  o   oO  \___/ /   /\#000000000000000000000000000#
#00000000000000000000000000000000#   o.   \____ .o   .                        \___     .     .         .                                    .  ________o        \____/  #000000000000000000000000000#
#00000000000000000000000000000000#             \_________                         \___             .O..                                  .  __/ .    .o\____    .   .\__#000000000000000000000000000#
#00000000000000000000000000000000#                       \ o                          \ __________                                    _____/   .            \____   .    000000000000000000000000000#
#00000000000000000000000000000000#                   o    \____                       .      .    \__________    .          .o.  ____/  .                        \____   000000000000000000000000000#
#00000000000000000000000000000000#                  .          \__.                          .              .\__________________/                                   . \_ 000000000000000000000000000#
#00000000000000000000000000000000#                                \_                                                             .                                      #000000000000000000000000000#
#00000000000000000000000000000000#   o.                             \___    .o.                                                                                         #000000000000000000000000000#
#00000000000000000000000000000000#__                           .o       \________  .o   .                                                                               #000000000000000000000000000#
#00000000000000000000000000000000#  \____                                        \____________               .          .                                               #000000000000000000000000000#
#00000000000000000000000000000000#       \____________                                        \__________________                      ...           .o.        .       #000000000000000000000000000#
#00000000000000000000000000000000#                    \          .                               .o         .    \___________________      ____                         #000000000000000000000000000#
#00000000000000000000000000000000#                .o   \______                 .                             o                    .  \____/    \                        #000000000000000000000000000#
#00000000000000000000000000000000#       .                    \________                                              .              o.          \_                      #000000000000000000000000000#
#00000000000000000000000000000000#                      .              \__.     .         .o                               .Oo.               .o  \________             #000000000000000000000000000#
#00000000000000000000000000000000#                                  O.    \______                                  .        .                     .o       \__    .     #000000000000000000000000000#
#00000000000000000000000000000000#                                               \_______________                                                          o  \____     #000000000000000000000000000#
#00000000000000000000000000000000#                                                               \__________                                                  o    \__  #000000000000000000000000000#
#00000000000000000000000000000000#                                                                          \___________________ .o .                               . \_#000000000000000000000000000#
#00000000000000000000000000000000#                                                                                              \________     .                         #000000000000000000000000000#
#00000000000000000000000000000000#                                                                                                       \_____                         #000000000000000000000000000#
#00000000000000000000000000000000#                                                                                                             \___                     #000000000000000000000000000#
#00000000000000000000000000000000#                                                                                                                 \__      .           #000000000000000000000000000#
#00000000000000000000000000000000#                                                                                                                    \____             #000000000000000000000000000#
#00000000000000000000000000000000#                                                                                                                         \__     .    #000000000000000000000000000#
#00000000000000000000000000000000#                                                                                                                            \         #000000000000000000000000000#
#00000000000000000000000000000000########################################################################################################################################000000000000000000000000000#
#000000000000000000000000000000000000000000000000000000000000000000000000000000000000000000000000000000000000000000000000000000000000000000000000000000000000000000000000000000000000000000000000000#
#000000000000000000000000000000000000000000000000000000000000000000000000000000000000000000000000000000000000000000000000000000000000000000000000000000000000000000000000000000000000000000000000000#
#000000000000000000000000000000000000000000000000000000000000000000000000000000000000000000000000000000000000000000000000000000000000000000000000000000000000000000000000000000000000000000000000000#
#000000000000000000000000000000000000000000000000000000000000000000000000000000000000000000000000000000000000000000000000000000000000000000000000000000000000000000000000000000000000000000000000000#
#000000000000000000000000000000000000000000000000000000000000000000000000000000000000000000000000000000000000000000000000000000000000000000000000000000000000000000000000000000000000000000000000000#
#000000000000000000000000000000000000000000000000000000000000000000000000000000000000000000000000000000000000000000000000000000000000000000000000000000000000000000000000000000000000000000000000000#
#000000000000000000000000000000000000000000000000000000000000000000000000000000000000000000000000000000000000000000000000000000000000000000000000000000000000000000000000000000000000000000000000000#
#000000000000000000000000000000000000000000000000000000000000000000000000000000000000000000000000000000000000000000000000000000000000000000000000000000000000000000000000000000000000000000000000000#
#000000000000000000000000000000000000000000000000000000000000000000000000000000000000000000000000000000000000000000000000000000000000000000000000000000000000000000000000000000000000000000000000000#
#000000000000000000000000000000000000000000000000000000000000000000000000000000000000000000000000000000000000000000000000000000000000000000000000000000000000000000000000000000000000000000000000000#
#000000000000000000000000000000000000000000000000000000000000000000000000000000000000000000000000000000000000000000000000000000000000000000000000000000000000000000000000000000000000000000000000000#
#000000000000000000000000000000000000000000000000000000000000000000000000000000000000000000000000000000000000000000000000000000000000000000000000000000000000000000000000000000000000000000000000000#
#000000000000000000000000000000000000000000000000000000000000000000000000000000000000000000000000000000000000000000000000000000000000000000000000000000000000000000000000000000000000000000000000000#
#000000000000000000000000000000000000000000000000000000000000000000000000000000000000000000000000000000000000000000000000000000000000000000000000000000000000000000000000000000000000000000000000000#
#000000000000000000000000000000000000000000000000000000000000000000000000000000000000000000000000000000000000000000000000000000000000000000000000000000000000000000000000000000000000000000000000000#
#####################################################################################################################################################################################################                                          
