MAP.TXT
#####################################################################################################################################################################################################
#000000000000000000000000000000000000000000000000000000000000000000000000000000000000000000000000000000000000000000000000000000000000000000000000000000000000000000000000000000000000000000000000000#
#000000000000000000000000000000000000000000000000000000000000000000000000000000000000000000000000000000000000000000000000000000000000000000000000000000000000000000000000000000000000000000000000000#
#000000000000000000000000000000000000000000000000000000000000000000000000000000000000000000000000000000000000000000000000000000000000000000000000000000000000000000000000000000000000000000000000000#
#000000000000000000000000000000000000000000000000000000000000000000000000000000000000000000000000000000000000000000000000000000000000000000000000000000000000000000000000000000000000000000000000000#
#000000000000000000000000000000000000000000000000000000000000000000000000000000000000000000000000000000000000000000000000000000000000000000000000000000000000000000000000000000000000000000000000000#
#000000000000000000000000000000000000000000000000000000000000000000000000000000000000000000000000000000000000000000000000000000000000000000000000000000000000000000000000000000000000000000000000000#
#000000000000000000000000000000000000000000000000000000000000000000000000000000000000000000000000000000000000000000000000000000000000000000000000000000000000000000000000000000000000000000000000000#
#000000000000000000000000000000000000000000000000000000000000000000000000000000000000000000000000000000000000000000000000000000000000000000000000000000000000000000000000000000000000000000000000000#
#000000000000000000000000000000000000000000000000000000000000000000000000000000000000000000000000000000000000000000000000000000000000000000000000000000000000000000000000000000000000000000000000000#
#000000000000000000000000000000000000000000000000000000000000000000000000000000000000000000000000000000000000000000000000000000000000000000000000000000000000000000000000000000000000000000000000000#
#000000000000000000000000000000000000000000000000000000000000000000000000000000000000000000000000000000000000000000000000000000000000000000000000000000000000000000000000000000000000000000000000000#
#000000000000000000000000000000000000000000000000000000000000000000000000000000000000000000000000000000000000000000000000000000000000000000000000000000000000000000000000000000000000000000000000000#
#000000000000000000000000000000000000000000000000000000000000000000000000000000000000000000000000000000000000000000000000000000000000000000000000000000000000000000000000000000000000000000000000000#
#000000000000000000000000000000000000000000000000000000000000000000000000000000000000000000000000000000000000000000000000000000000000000000000000000000000000000000000000000000000000000000000000000#
#000000000000000000000000000000000000000000000000000000000000000000000000000000000000000000000000000000000000000000000000000000000000000000000000000000000000000000000000000000000000000000000000000#
#00000000000000000000000000000000########################################################################################################################################000000000000000000000000000#
#00000000000000000000000000000000#                                                                                                                                      #000000000000000000000000000#
#00000000000000000000000000000000#                                                                                                                                      #000000000000000000000000000#
#00000000000000000000000000000000#                                                                                                                                      #000000000000000000000000000#
#00000000000000000000000000000000#                                                                                                                                      #000000000000000000000000000#
#00000000000000000000000000000000#                                                                                                                                      #000000000000000000000000000#
#00000000000000000000000000000000#                                                                                                                                      #000000000000000000000000000#
#00000000000000000000000000000000#                                                                                                                                      #000000000000000000000000000#
#00000000000000000000000000000000#                                                                                                                                      #000000000000000000000000000#
#00000000000000000000000000000000#                                                                                                                                      #000000000000000000000000000#
#00000000000000000000000000000000#                                                                                                                                      #000000000000000000000000000#
#00000000000000000000000000000000#                                                                                                                                      #000000000000000000000000000#
#00000000000000000000000000000000#                                                                                                                                      #000000000000000000000000000#
#00000000000000000000000000000000#                                                                                                                                      #000000000000000000000000000#
#00000000000000000000000000000000#                                                                                                                                      #000000000000000000000000000#
#00000000000000000000000000000000#                                                                                                                                      #000000000000000000000000000#
#00000000000000000000000000000000#                                                                                                                                      #000000000000000000000000000#
#00000000000000000000000000000000#                                                                                                                                      #000000000000000000000000000#
#00000000000000000000000000000000#                                                                                                                                      #000000000000000000000000000#
#00000000000000000000000000000000#                                                                                                                                      #000000000000000000000000000#
#00000000000000000000000000000000#                                                                                                                                      #000000000000000000000000000#
#00000000000000000000000000000000#                                                                                                                                      #000000000000000000000000000#
#00000000000000000000000000000000#                                    \                                                        /  /                                     #000000000000000000000000000#
#00000000000000000000000000000000#                         \           \                                                      /  /      /                               #000000000000000000000000000#
#00000000000000000000000000000000#               \          \           \                                                    /  /      /       /                        #000000000000000000000000000#
#00000000000000000000000000000000#                \          \           \_________________________________________________ /  /      /       /                         #000000000000000000000000000#
#00000000000000000000000000000000#      \          \          \__________/      .                                          \__/      /       /         /                #000000000000000000000000000#
#00000000000000000000000000000000#  \    \          \_________/ Oo.         .                                                 \_____/       /     /   /                 #000000000000000000000000000#
#00000000000000000000000000000000#   \    \_________/ . o .                                                                         \      /     /   /                  #000000000000000000000000000#
#00000000000000000000000000000000#\   \ __/                .                                             .          .                \___ /     /   /                   #000000000000000000000000000#
#00000000000000000000000000000000# \ __/  .                                             .              .                                 \     /   /                    #000000000000000000000000000#
#00000000000000000000000000000000#__/     .                                                                    __     .                   \__ /   /                     #000000000000000000000000000#
#00000000000000000000000000000000#                                                  .                         /  \            .              \__ /                      #000000000000000000000000000#
#00000000000000000000000000000000#                                                                           /    \             .               \                       #000000000000000000000000000#
#00000000000000000000000000000000#                                                                           |    |             .               /                       #000000000000000000000000000#
#00000000000000000000000000000000#                                                                        .O.\____/O.                .       __/___                     #000000000000000000000000000#
#00000000000000000000000000000000#___  .                                                                    ." . "".               .      __/      \_                  _#000000000000000000000000000#
#00000000000000000000000000000000#   \___.          .                                                                           .        /           \________________/ #000000000000000000000000000#
#00000000000000000000000000000000#        \________   ..            .                                                        .       ___/                               #000000000000000000000000000#
#00000000000000000000000000000000#        O.       \____________________         .                                      .        ___/  .            .                   #000000000000000000000000000#
#00000000000000000000000000000000#   .                                  \_______   .                           .                /  O.                .         .   .    #000000000000000000000000000#
#00000000000000000000000000000000#                                              \______________________________________________/         .                          .   #000000000000000000000000000#
#00000000000000000000000000000000#     .                      .                                                     .     .O .   .       .         o                    #000000000000000000000000000#
#00000000000000000000000000000000#                 .   .O.                   .       .O.                                   .o                      .     . O .          #000000000000000000000000000#
#00000000000000000000000000000000#       .                                                                       .O o.      .O  .O.       .                             #000000000000000000000000000#
#00000000000000000000000000000000#                                         .                  .                .  ..     .  oO .     .       .           .     .   .    #000000000000000000000000000#
#00000000000000000000000000000000#                                                .                             .            .o  O .  .        .                       _#000000000000000000000000000#
#00000000000000000000000000000000#     .          .                                                                         .o .             .              .    _____/ #000000000000000000000000000#
#00000000000000000000000000000000#_______                     O.                                                             .Oo . .   .           .       _____/       #000000000000000000000000000#
#00000000000000000000000000000000#       \_____     .                                                        .O.    .         .o.    .                 ___/             #000000000000000000000000000#
#00000000000000000000000000000000#             \___________________________                                                  .O..   .           .  ___/                 #000000000000000000000000000#
#00000000000000000000000000000000#                                         \_______________                                .   o        __________?                     #000000000000000000000000000#
#00000000000000000000000000000000#                                                         \___________________________________________/                                #000000000000000000000000000#
#00000000000000000000000000000000#                                                                                                                                      #000000000000000000000000000#
#00000000000000000000000000000000#                                                                                                                                      #000000000000000000000000000#
#00000000000000000000000000000000########################################################################################################################################000000000000000000000000000#
#000000000000000000000000000000000000000000000000000000000000000000000000000000000000000000000000000000000000000000000000000000000000000000000000000000000000000000000000000000000000000000000000000#
#000000000000000000000000000000000000000000000000000000000000000000000000000000000000000000000000000000000000000000000000000000000000000000000000000000000000000000000000000000000000000000000000000#
#000000000000000000000000000000000000000000000000000000000000000000000000000000000000000000000000000000000000000000000000000000000000000000000000000000000000000000000000000000000000000000000000000#
#000000000000000000000000000000000000000000000000000000000000000000000000000000000000000000000000000000000000000000000000000000000000000000000000000000000000000000000000000000000000000000000000000#
#000000000000000000000000000000000000000000000000000000000000000000000000000000000000000000000000000000000000000000000000000000000000000000000000000000000000000000000000000000000000000000000000000#
#000000000000000000000000000000000000000000000000000000000000000000000000000000000000000000000000000000000000000000000000000000000000000000000000000000000000000000000000000000000000000000000000000#
#000000000000000000000000000000000000000000000000000000000000000000000000000000000000000000000000000000000000000000000000000000000000000000000000000000000000000000000000000000000000000000000000000#
#000000000000000000000000000000000000000000000000000000000000000000000000000000000000000000000000000000000000000000000000000000000000000000000000000000000000000000000000000000000000000000000000000#
#000000000000000000000000000000000000000000000000000000000000000000000000000000000000000000000000000000000000000000000000000000000000000000000000000000000000000000000000000000000000000000000000000#
#000000000000000000000000000000000000000000000000000000000000000000000000000000000000000000000000000000000000000000000000000000000000000000000000000000000000000000000000000000000000000000000000000#
#000000000000000000000000000000000000000000000000000000000000000000000000000000000000000000000000000000000000000000000000000000000000000000000000000000000000000000000000000000000000000000000000000#
#000000000000000000000000000000000000000000000000000000000000000000000000000000000000000000000000000000000000000000000000000000000000000000000000000000000000000000000000000000000000000000000000000#
#000000000000000000000000000000000000000000000000000000000000000000000000000000000000000000000000000000000000000000000000000000000000000000000000000000000000000000000000000000000000000000000000000#
#000000000000000000000000000000000000000000000000000000000000000000000000000000000000000000000000000000000000000000000000000000000000000000000000000000000000000000000000000000000000000000000000000#
#000000000000000000000000000000000000000000000000000000000000000000000000000000000000000000000000000000000000000000000000000000000000000000000000000000000000000000000000000000000000000000000000000#
#####################################################################################################################################################################################################                                          
