MAP.TXT
#####################################################################################################################################################################################################
#000000000000000000000000000000000000000000000000000000000000000000000000000000000000000000000000000000000000000000000000000000000000000000000000000000000000000000000000000000000000000000000000000#
#000000000000000000000000000000000000000000000000000000000000000000000000000000000000000000000000000000000000000000000000000000000000000000000000000000000000000000000000000000000000000000000000000#
#000000000000000000000000000000000000000000000000000000000000000000000000000000000000000000000000000000000000000000000000000000000000000000000000000000000000000000000000000000000000000000000000000#
#000000000000000000000000000000000000000000000000000000000000000000000000000000000000000000000000000000000000000000000000000000000000000000000000000000000000000000000000000000000000000000000000000#
#000000000000000000000000000000000000000000000000000000000000000000000000000000000000000000000000000000000000000000000000000000000000000000000000000000000000000000000000000000000000000000000000000#
#000000000000000000000000000000000000000000000000000000000000000000000000000000000000000000000000000000000000000000000000000000000000000000000000000000000000000000000000000000000000000000000000000#
#000000000000000000000000000000000000000000000000000000000000000000000000000000000000000000000000000000000000000000000000000000000000000000000000000000000000000000000000000000000000000000000000000#
#000000000000000000000000000000000000000000000000000000000000000000000000000000000000000000000000000000000000000000000000000000000000000000000000000000000000000000000000000000000000000000000000000#
#000000000000000000000000000000000000000000000000000000000000000000000000000000000000000000000000000000000000000000000000000000000000000000000000000000000000000000000000000000000000000000000000000#
#000000000000000000000000000000000000000000000000000000000000000000000000000000000000000000000000000000000000000000000000000000000000000000000000000000000000000000000000000000000000000000000000000#
#000000000000000000000000000000000000000000000000000000000000000000000000000000000000000000000000000000000000000000000000000000000000000000000000000000000000000000000000000000000000000000000000000#
#000000000000000000000000000000000000000000000000000000000000000000000000000000000000000000000000000000000000000000000000000000000000000000000000000000000000000000000000000000000000000000000000000#
#000000000000000000000000000000000000000000000000000000000000000000000000000000000000000000000000000000000000000000000000000000000000000000000000000000000000000000000000000000000000000000000000000#
#000000000000000000000000000000000000000000000000000000000000000000000000000000000000000000000000000000000000000000000000000000000000000000000000000000000000000000000000000000000000000000000000000#
#000000000000000000000000000000000000000000000000000000000000000000000000000000000000000000000000000000000000000000000000000000000000000000000000000000000000000000000000000000000000000000000000000#
#00000000000000000000000000000000########################################################################################################################################000000000000000000000000000#
#00000000000000000000000000000000#                                                                                                                                      #000000000000000000000000000#
#00000000000000000000000000000000#                                 _______________________                                                                              #000000000000000000000000000#
#00000000000000000000000000000000#                                /_____________________ /\                                                                             #000000000000000000000000000#
#00000000000000000000000000000000#                               /______________________/ /\                                                                            #000000000000000000000000000#
#00000000000000000000000000000000#                              /                       \/ /\                                                                           #000000000000000000000000000#
#00000000000000000000000000000000#                             /-------------------------\/ /               _________________________                                   #000000000000000000000000000#
#00000000000000000000000000000000#                            /|    ____                 |\/               //////////////////////////|                                   000000000000000000000000000#
#00000000000000000000000000000000#                             |   |----|      _ _ _ _   | |              ////////////////////////// |                                   000000000000000000000000000#
#00000000000000000000000000000000#                             |---|   '|-----|_|_|_|_|  | /             //////////////////////////  |                                  #000000000000000000000000000#
#00000000000000000000000000000000#                             |___|____|________________|/                 |   ___     _ _ _ _   |  |                                  #000000000000000000000000000#
#00000000000000000000000000000000#                                                                          |  |   |   |_|_|_|_|  |  |                                  #000000000000000000000000000#
#00000000000000000000000000000000#                                                                          |==|  '|==============| /                                   #000000000000000000000000000#
#00000000000000000000000000000000#                                _____________________                    /|__|___|______________|/                                    #000000000000000000000000000#
#00000000000000000000000000000000#                                \ o o o o o o o o o o\                  //                     /|                                     #000000000000000000000000000#
#00000000000000000000000000000000#                                 \ o o o o o o o o o o\                //                     //                                      #000000000000000000000000000#
#00000000000000000000000000000000#                                  \ o o o o o o o o o o\              //_______________     _//                                       #000000000000000000000000000#
#00000000000000000000000000000000#                                   \____________________\            |/_|_|_|_|_|_|_|_|     |/                                        #000000000000000000000000000#
#00000000000000000000000000000000#                                                                                                                                      #000000000000000000000000000#
#00000000000000000000000000000000#                                                                                                                                      #000000000000000000000000000#
#00000000000000000000000000000000#                                                                                                                                      #000000000000000000000000000#
#00000000000000000000000000000000#                                                                                                                                      #000000000000000000000000000#
#00000000000000000000000000000000#                                                             //v\\                                                                    #000000000000000000000000000#
#00000000000000000000000000000000#                                                              | |                                                                     #000000000000000000000000000#
#00000000000000000000000000000000#                                                         _---/| |\---_                                                                #000000000000000000000000000#
#00000000000000000000000000000000#                                                        //   \___/   \\                                                               #000000000000000000000000000#
#00000000000000000000000000000000#                                                        |\___________/|                                                               #000000000000000000000000000#
#00000000000000000000000000000000#                                                        \_____________/                                                               #000000000000000000000000000#
#00000000000000000000000000000000#                                                                                                                                      #000000000000000000000000000#
#00000000000000000000000000000000#                                                                                                                                      #000000000000000000000000000#
#00000000000000000000000000000000#                                                                                                                                      #000000000000000000000000000#
#00000000000000000000000000000000#                                                                                                                                      #000000000000000000000000000#
#00000000000000000000000000000000#                                                                                                                                      #000000000000000000000000000#
#00000000000000000000000000000000#                                                                                                                                      #000000000000000000000000000#
#00000000000000000000000000000000#                                                                                                                                      #000000000000000000000000000#
#00000000000000000000000000000000#                                                                                                                                      #000000000000000000000000000#
#00000000000000000000000000000000#                                                                                                                                      #000000000000000000000000000#
#00000000000000000000000000000000#                                                                                                                                      #000000000000000000000000000#
#00000000000000000000000000000000#                                                                                                                                      #000000000000000000000000000#
#00000000000000000000000000000000#                                                                                                                                      #000000000000000000000000000#
#00000000000000000000000000000000#                                                                                                                                      #000000000000000000000000000#
#00000000000000000000000000000000#                                                                                                                                      #000000000000000000000000000#
#00000000000000000000000000000000#                                                                                                                                      #000000000000000000000000000#
#00000000000000000000000000000000#                                                                                                                                      #000000000000000000000000000#
#00000000000000000000000000000000#                                                                                                                                      #000000000000000000000000000#
#00000000000000000000000000000000#                                                                                                                                      #000000000000000000000000000#
#00000000000000000000000000000000#                                                                                                                                      #000000000000000000000000000#
#00000000000000000000000000000000#                                                                                                                                      #000000000000000000000000000#
#00000000000000000000000000000000#                                                                                                                                      #000000000000000000000000000#
#00000000000000000000000000000000#                                                                                                                                      #000000000000000000000000000#
#00000000000000000000000000000000#                                                                                                                                      #000000000000000000000000000#
#00000000000000000000000000000000#                                                                                                                                      #000000000000000000000000000#
#00000000000000000000000000000000#                                                                                                                                      #000000000000000000000000000#
#00000000000000000000000000000000#                                                                                                                                      #000000000000000000000000000#
#00000000000000000000000000000000#                                                                                                                                      #000000000000000000000000000#
#00000000000000000000000000000000########################################################################################################################################000000000000000000000000000#
#000000000000000000000000000000000000000000000000000000000000000000000000000000000000000000000000000000000000000000000000000000000000000000000000000000000000000000000000000000000000000000000000000#
#000000000000000000000000000000000000000000000000000000000000000000000000000000000000000000000000000000000000000000000000000000000000000000000000000000000000000000000000000000000000000000000000000#
#000000000000000000000000000000000000000000000000000000000000000000000000000000000000000000000000000000000000000000000000000000000000000000000000000000000000000000000000000000000000000000000000000#
#000000000000000000000000000000000000000000000000000000000000000000000000000000000000000000000000000000000000000000000000000000000000000000000000000000000000000000000000000000000000000000000000000#
#000000000000000000000000000000000000000000000000000000000000000000000000000000000000000000000000000000000000000000000000000000000000000000000000000000000000000000000000000000000000000000000000000#
#000000000000000000000000000000000000000000000000000000000000000000000000000000000000000000000000000000000000000000000000000000000000000000000000000000000000000000000000000000000000000000000000000#
#000000000000000000000000000000000000000000000000000000000000000000000000000000000000000000000000000000000000000000000000000000000000000000000000000000000000000000000000000000000000000000000000000#
#000000000000000000000000000000000000000000000000000000000000000000000000000000000000000000000000000000000000000000000000000000000000000000000000000000000000000000000000000000000000000000000000000#
#000000000000000000000000000000000000000000000000000000000000000000000000000000000000000000000000000000000000000000000000000000000000000000000000000000000000000000000000000000000000000000000000000#
#000000000000000000000000000000000000000000000000000000000000000000000000000000000000000000000000000000000000000000000000000000000000000000000000000000000000000000000000000000000000000000000000000#
#000000000000000000000000000000000000000000000000000000000000000000000000000000000000000000000000000000000000000000000000000000000000000000000000000000000000000000000000000000000000000000000000000#
#000000000000000000000000000000000000000000000000000000000000000000000000000000000000000000000000000000000000000000000000000000000000000000000000000000000000000000000000000000000000000000000000000#
#000000000000000000000000000000000000000000000000000000000000000000000000000000000000000000000000000000000000000000000000000000000000000000000000000000000000000000000000000000000000000000000000000#
#000000000000000000000000000000000000000000000000000000000000000000000000000000000000000000000000000000000000000000000000000000000000000000000000000000000000000000000000000000000000000000000000000#
#000000000000000000000000000000000000000000000000000000000000000000000000000000000000000000000000000000000000000000000000000000000000000000000000000000000000000000000000000000000000000000000000000#
#####################################################################################################################################################################################################
