MAP.TXT
#####################################################################################################################################################################################################
#000000000000000000000000000000000000000000000000000000000000000000000000000000000000000000000000000000000000000000000000000000000000000000000000000000000000000000000000000000000000000000000000000#
#000000000000000000000000000000000000000000000000000000000000000000000000000000000000000000000000000000000000000000000000000000000000000000000000000000000000000000000000000000000000000000000000000#
#000000000000000000000000000000000000000000000000000000000000000000000000000000000000000000000000000000000000000000000000000000000000000000000000000000000000000000000000000000000000000000000000000#
#000000000000000000000000000000000000000000000000000000000000000000000000000000000000000000000000000000000000000000000000000000000000000000000000000000000000000000000000000000000000000000000000000#
#000000000000000000000000000000000000000000000000000000000000000000000000000000000000000000000000000000000000000000000000000000000000000000000000000000000000000000000000000000000000000000000000000#
#000000000000000000000000000000000000000000000000000000000000000000000000000000000000000000000000000000000000000000000000000000000000000000000000000000000000000000000000000000000000000000000000000#
#000000000000000000000000000000000000000000000000000000000000000000000000000000000000000000000000000000000000000000000000000000000000000000000000000000000000000000000000000000000000000000000000000#
#000000000000000000000000000000000000000000000000000000000000000000000000000000000000000000000000000000000000000000000000000000000000000000000000000000000000000000000000000000000000000000000000000#
#000000000000000000000000000000000000000000000000000000000000000000000000000000000000000000000000000000000000000000000000000000000000000000000000000000000000000000000000000000000000000000000000000#
#000000000000000000000000000000000000000000000000000000000000000000000000000000000000000000000000000000000000000000000000000000000000000000000000000000000000000000000000000000000000000000000000000#
#000000000000000000000000000000000000000000000000000000000000000000000000000000000000000000000000000000000000000000000000000000000000000000000000000000000000000000000000000000000000000000000000000#
#000000000000000000000000000000000000000000000000000000000000000000000000000000000000000000000000000000000000000000000000000000000000000000000000000000000000000000000000000000000000000000000000000#
#000000000000000000000000000000000000000000000000000000000000000000000000000000000000000000000000000000000000000000000000000000000000000000000000000000000000000000000000000000000000000000000000000#
#000000000000000000000000000000000000000000000000000000000000000000000000000000000000000000000000000000000000000000000000000000000000000000000000000000000000000000000000000000000000000000000000000#
#000000000000000000000000000000000000000000000000000000000000000000000000000000000000000000000000000000000000000000000000000000000000000000000000000000000000000000000000000000000000000000000000000#
#00000000000000000000000000000000########################################################################################################################################000000000000000000000000000#
#00000000000000000000000000000000#                                                                                                                                      #000000000000000000000000000#
#00000000000000000000000000000000#                                                                                                                                      #000000000000000000000000000#
#00000000000000000000000000000000#                                                                                                                                      #000000000000000000000000000#
#00000000000000000000000000000000#                                                                                                                                      #000000000000000000000000000#
#00000000000000000000000000000000#                                                                                                                                      #000000000000000000000000000#
#00000000000000000000000000000000#                                                                                                                                      #000000000000000000000000000#
#00000000000000000000000000000000#         ___________________                                                                                                          #000000000000000000000000000#
#00000000000000000000000000000000#        /  _  - ____   -   /\                                                                                                         #000000000000000000000000000#
#00000000000000000000000000000000#   ____/_/    -/    \ -   /  \                                                                                                        #000000000000000000000000000#
#00000000000000000000000000000000#__/\  _\ \ / __|    |____/\ \ \                                                                                                       #000000000000000000000000000#
#00000000000000000000000000000000#  \ \   \   /       .   .\    /\__                                                                                                    #000000000000000000000000000#
#00000000000000000000000000000000#      \____/              \  /  / \                                 \                                                                 #000000000000000000000000000#
#00000000000000000000000000000000# / \__/  Oo .    ..   .    \/__/   \                                |\___                                                             #000000000000000000000000000#
#00000000000000000000000000000000#   /      .                    \    \_                              |  - \____                                                        #000000000000000000000000000#
#00000000000000000000000000000000#\_/.                     .      \__/  \   .                         \__  |    \_________                                              #000000000000000000000000000#
#00000000000000000000000000000000#/   .                  o.   .      \   \__                             \_| _- /  -   __/                                              #000000000000000000000000000#
#00000000000000000000000000000000#           o       .              . \_/   \.                        .O   \__ _  ____/                                                 #000000000000000000000000000#
#00000000000000000000000000000000#.              ..      .      .       \_   \_   o                           \__/                                                      #000000000000000000000000000#
#00000000000000000000000000000000#             .  .            .  .     . \__/ \  .                      .                                                              #000000000000000000000000000#
#00000000000000000000000000000000#        .           .o          .          \_ \                                                                                       #000000000000000000000000000#
#00000000000000000000000000000000#                      . o.          . .  .   \_\                                                                                      #000000000000000000000000000#
#00000000000000000000000000000000#       o                 o.       .      .                                                                                            #000000000000000000000000000#
#00000000000000000000000000000000#                             .                              . .   _                                                                   #000000000000000000000000000#
#00000000000000000000000000000000#                       .     .o                                __/ \_                                                                 #000000000000000000000000000#
#00000000000000000000000000000000#          .         o.        .         .                     /__    /\                                                               #000000000000000000000000000#
#00000000000000000000000000000000#                               .        .                        \__/  \_                                                             #000000000000000000000000000#
#00000000000000000000000000000000#                                                                    \    \__                                                          #000000000000000000000000000#
#00000000000000000000000000000000                                                                   .O \      \                                                         #000000000000000000000000000#
#00000000000000000000000000000000            .                  .o                                      \      \___                                                     #000000000000000000000000000#
#00000000000000000000000000000000#                                       .                               \_/       \____                                               #000000000000000000000000000#
#00000000000000000000000000000000#            o                       .                                    \    /       \                                               #000000000000000000000000000#
#00000000000000000000000000000000#                      o    .      .  .. .                                 \__/         \__________                                    #000000000000000000000000000#
#00000000000000000000000000000000#                   . .  . o o     .     .                                    \                    \                                   #000000000000000000000000000#
#00000000000000000000000000000000#                 .o      .   o.   .           .                               \     /              \                                  #000000000000000000000000000#
#00000000000000000000000000000000#           .            .                      .                               \___/       /        \______                           #000000000000000000000000000#
#00000000000000000000000000000000#                  .o o         . o. o.        .O.                                  \      /         /      \________                  #000000000000000000000000000#
#00000000000000000000000000000000#           .               .o         o.                                            \____/                          \___              #000000000000000000000000000#
#00000000000000000000000000000000#             .         .           .  .o  .      .                            .O         \        /  -                  \             #000000000000000000000000000#
#00000000000000000000000000000000#                        .o      .  .o  .       .      .                                   \      /      /                \________    #000000000000000000000000000#
#00000000000000000000000000000000#              .       o               .             .                                      \    /  _   /\ -      /\   \           \   #000000000000000000000000000#
#00000000000000000000000000000000#                      .           .  .    .o             .                                  \  /      /     _   /                  \__#000000000000000000000000000#
#00000000000000000000000000000000#         .        .o       o    o.                                                           \/__    /         /                      #000000000000000000000000000#
#00000000000000000000000000000000#             o       .               .       .. o  o..     .                                     \__/         /   \    /              #000000000000000000000000000#
#00000000000000000000000000000000#                   .    .o .           .          .                                                 \        /  \     /               #000000000000000000000000000#
#00000000000000000000000000000000#         o      .      .  o  .o        .     .       .    .           .                              \______/        /        \  \    #000000000000000000000000000#
#00000000000000000000000000000000#           .     o . o  O      .         o  .            .Oo                                                 \  \   /                 #000000000000000000000000000#
#00000000000000000000000000000000#          . . .           .o       .           . .   .                .                                       \    /    /             #000000000000000000000000000#
#00000000000000000000000000000000#     .  .       o   .  .       .o                                      o.                                      \  /  /  /             #000000000000000000000000000#
#00000000000000000000000000000000#             .   o       .o             .                    .                                                  \/_____//             #000000000000000000000000000#
#00000000000000000000000000000000#                                 .o   .      .   .                                                                     \     \    /   #000000000000000000000000000#
#00000000000000000000000000000000#  o    .    o    .   . .                   .    .o          o            .   .o  .o                                     \             #000000000000000000000000000#
#00000000000000000000000000000000#   . .   O     .   .o   o    .                   .     .                .       o. .                                     \            #000000000000000000000000000#
#00000000000000000000000000000000#        .    .    ..       .   o  o                  .                      . .                                           \  \    \   #000000000000000000000000000#
#00000000000000000000000000000000#                                  .          o       o                        .                                            \          #000000000000000000000000000#
#00000000000000000000000000000000########################################################################################################################################000000000000000000000000000#
#000000000000000000000000000000000000000000000000000000000000000000000000000000000000000000000000000000000000000000000000000000000000000000000000000000000000000000000000000000000000000000000000000#
#000000000000000000000000000000000000000000000000000000000000000000000000000000000000000000000000000000000000000000000000000000000000000000000000000000000000000000000000000000000000000000000000000#
#000000000000000000000000000000000000000000000000000000000000000000000000000000000000000000000000000000000000000000000000000000000000000000000000000000000000000000000000000000000000000000000000000#
#000000000000000000000000000000000000000000000000000000000000000000000000000000000000000000000000000000000000000000000000000000000000000000000000000000000000000000000000000000000000000000000000000#
#000000000000000000000000000000000000000000000000000000000000000000000000000000000000000000000000000000000000000000000000000000000000000000000000000000000000000000000000000000000000000000000000000#
#000000000000000000000000000000000000000000000000000000000000000000000000000000000000000000000000000000000000000000000000000000000000000000000000000000000000000000000000000000000000000000000000000#
#000000000000000000000000000000000000000000000000000000000000000000000000000000000000000000000000000000000000000000000000000000000000000000000000000000000000000000000000000000000000000000000000000#
#000000000000000000000000000000000000000000000000000000000000000000000000000000000000000000000000000000000000000000000000000000000000000000000000000000000000000000000000000000000000000000000000000#
#000000000000000000000000000000000000000000000000000000000000000000000000000000000000000000000000000000000000000000000000000000000000000000000000000000000000000000000000000000000000000000000000000#
#000000000000000000000000000000000000000000000000000000000000000000000000000000000000000000000000000000000000000000000000000000000000000000000000000000000000000000000000000000000000000000000000000#
#000000000000000000000000000000000000000000000000000000000000000000000000000000000000000000000000000000000000000000000000000000000000000000000000000000000000000000000000000000000000000000000000000#
#000000000000000000000000000000000000000000000000000000000000000000000000000000000000000000000000000000000000000000000000000000000000000000000000000000000000000000000000000000000000000000000000000#
#000000000000000000000000000000000000000000000000000000000000000000000000000000000000000000000000000000000000000000000000000000000000000000000000000000000000000000000000000000000000000000000000000#
#000000000000000000000000000000000000000000000000000000000000000000000000000000000000000000000000000000000000000000000000000000000000000000000000000000000000000000000000000000000000000000000000000#
#000000000000000000000000000000000000000000000000000000000000000000000000000000000000000000000000000000000000000000000000000000000000000000000000000000000000000000000000000000000000000000000000000#
#####################################################################################################################################################################################################                                          
